16,100
1,2
2,3,4,5,6,7,2,2,2,2,2
3,2,4,5,6,7,3,3,3,3,3
4,2,3,5,6,7,4,4,4,4,4
5,2,3,4,6,7,5,5,5,5,5
6,2,3,4,5,7,6,6,6,6,6
7,2,3,4,5,6,8,9,7,7,7
8,7,10,12,8,8,8,8,8,8,8
9,7,10,12,9,9,9,9,9,9,9
10,8,9,11,10,10,10,10,10,10,10
11,10,13,11,11,11,11,11,11,11,11
12,8,9,13,12,12,12,12,12,12,12
13,11,12,14,13,13,13,13,13,13,13
14,13,15,14,14,14,14,14,14,14,14
15,14,16,15,15,15,15,15,15,15,15
16,15