13,100
1,2
2,1,3,4,5,6,7,8,9,10,11,12
3,2,4,5,6,7,8,9,10,11,12
4,2,3,5,6,7,8,9,10,11,12
5,2,3,4,6,7,8,9,10,11,12
6,2,3,4,5,7,8,9,10,11,12
7,2,3,4,5,6,8,9,10,11,12
8,2,3,4,5,6,7,9,10,11,12
9,2,3,4,5,6,7,8,10,11,12
10,2,3,4,5,6,7,8,9,11,12
11,2,3,4,5,6,7,8,9,10,12
12,2,3,4,5,6,7,8,9,10,11,13
13,12
