23,500
1,2
2,1,3,4,4,5,5,14,14,15,15
4,2,2,6,6,8,8,10,10,12,12
5,2,2,7,7,9,9,11,11,13,13
6,4,4,6,6,8,8,10,10,12,12
7,5,5,7,7,9,9,11,11,13,13
8,4,4,6,6,8,8,10,10,12,12
9,5,5,7,7,9,9,11,11,13,13
10,4,4,6,6,8,8,10,10,12,12
11,5,5,7,7,9,9,11,11,13,13
12,4,4,6,6,8,8,10,10,12,12
13,5,5,7,7,9,9,11,11,13,13
14,2,2,16,16,18,18,20,20,22,22
15,2,2,17,17,19,19,21,21,23,23
16,14,14,16,16,18,18,20,20,22,22
17,15,15,17,17,19,19,21,21,23,23
18,14,14,16,16,18,18,20,20,22,22
19,15,15,17,17,19,19,21,21,23,23
20,14,14,16,16,18,18,20,20,22,22
21,15,15,17,17,19,19,21,21,23,23
22,14,14,16,16,18,18,20,20,22,22
23,15,15,17,17,19,19,21,21,23,23
3,2