39,1000
1,2
2,1,3,4,5,6,7,8,9,10,11
3,2,36,4,5,6,7,8,9,10,11
4,2,3,25,5,6,7,8,9,10,11
5,2,3,4,5,6,7,8,9,10,11
6,2,3,4,5,6,7,8,9,10,11
7,2,3,4,5,6,7,8,9,10,11
8,2,3,4,5,6,7,8,9,10,11
9,2,3,4,5,6,7,8,9,10,11
10,2,3,4,5,6,7,8,9,10,11
11,2,3,4,5,6,7,8,9,10,12
12,11,13,14,15,16,17,18,19,20,21
13,12,13,13,13,13,13,13,13,13,13
14,12,22,14,14,14,14,14,14,14,14
15,12,23,15,15,15,15,15,15,15,15
16,12,24,16,16,16,16,16,16,16,16
17,12,25,17,17,17,17,17,17,17,17
18,12,26,18,18,18,18,18,18,18,18
19,12,27,19,19,19,19,19,19,19,19
20,12,28,20,20,20,20,20,20,20,20
21,12,21,21,21,21,21,21,21,21,21
22,14,22,22,22,22,22,22,22,22,22
23,15,23,23,23,23,23,23,23,23,23
24,16,24,24,24,24,24,24,24,24,24
25,4,17,29,25,25,25,25,25,25,25
26,18,26,26,26,26,26,26,26,26,26
27,19,27,27,27,27,27,27,27,27,27
28,20,28,28,28,28,28,28,28,28,28
29,25,30,31,32,33,34,35,36,37,38
30,29,30,31,32,33,34,35,36,37,38
31,29,30,31,32,33,34,35,36,37,38
32,29,30,31,32,33,34,35,36,37,38
33,29,30,31,32,33,34,35,36,37,38
34,29,30,31,32,33,34,35,36,37,38
35,29,30,31,32,33,34,35,36,37,38
36,3,29,30,31,32,33,34,35,37,38
37,29,30,31,32,33,34,35,36,37,38
38,29,30,31,32,33,34,35,36,37,39
39,38
