123,1230
1,62
2,3,3,13,13,122,122,2,2,2,2
3,2,2,4,4,14,14,3,3,3,3
4,3,3,5,5,15,15,4,4,4,4
5,4,4,6,6,16,16,5,5,5,5
6,5,5,7,7,17,17,6,6,6,6
7,6,6,8,8,18,18,7,7,7,7
8,7,7,9,9,19,19,8,8,8,8
9,8,8,10,10,20,20,9,9,9,9
10,9,9,11,11,21,21,10,10,10,10
11,10,10,12,12,22,22,11,11,11,11
12,11,11,23,23,112,112,12,12,12,12
13,2,2,14,14,24,24,13,13,13,13
14,3,3,13,13,15,15,25,25,14,14
15,4,4,14,14,16,16,26,26,15,15
16,5,5,15,15,17,17,27,27,16,16
17,6,6,16,16,18,18,28,28,17,17
18,7,7,17,17,19,19,29,29,18,18
19,8,8,18,18,20,20,30,30,19,19
20,9,9,19,19,21,21,31,31,20,20
21,10,10,20,20,22,22,32,32,21,21
22,11,11,21,21,23,23,33,33,22,22
23,12,12,22,22,34,34,23,23,23,23
24,13,13,25,25,35,35,24,24,24,24
25,14,14,24,24,26,26,36,36,25,25
26,15,15,25,25,27,27,37,37,26,26
27,16,16,26,26,28,28,38,38,27,27
28,17,17,27,27,29,29,39,39,28,28
29,18,18,28,28,30,30,40,40,29,29
30,19,19,29,29,31,31,41,41,30,30
31,20,20,30,30,32,32,42,42,31,31
32,21,21,31,31,33,33,43,43,32,32
33,22,22,32,32,34,34,44,44,33,33
34,23,23,33,33,45,45,34,34,34,34
35,24,24,36,36,46,46,35,35,35,35
36,25,25,35,35,37,37,47,47,36,36
37,26,26,36,36,38,38,48,48,37,37
38,27,27,37,37,39,39,49,49,38,38
39,28,28,38,38,40,40,50,50,39,39
40,29,29,39,39,41,41,51,51,40,40
41,30,30,40,40,42,42,52,52,41,41
42,31,31,41,41,43,43,53,53,42,42
43,32,32,42,42,44,44,54,54,43,43
44,33,33,43,43,45,45,55,55,44,44
45,34,34,44,44,56,56,45,45,45,45
46,35,35,47,47,57,57,46,46,46,46
47,36,36,46,46,48,48,58,58,47,47
48,37,37,47,47,49,49,59,59,48,48
49,38,38,48,48,50,50,60,60,49,49
50,39,39,49,49,51,51,61,61,50,50
51,40,40,50,50,52,52,62,62,51,51
52,41,41,51,51,53,53,63,63,52,52
53,42,42,52,52,54,54,64,64,53,53
54,43,43,53,53,55,55,65,65,54,54
55,44,44,54,54,56,56,66,66,55,55
56,45,45,55,55,67,67,56,56,56,56
57,46,46,58,58,68,68,57,57,57,57
58,47,47,57,57,59,59,69,69,58,58
59,48,48,58,58,60,60,70,70,59,59
60,49,49,59,59,61,61,71,71,60,60
61,50,50,60,60,62,62,72,72,61,61
62,1,51,51,61,61,63,63,73,73,62
63,52,52,62,62,64,64,74,74,63,63
64,53,53,63,63,65,65,75,75,64,64
65,54,54,64,64,66,66,76,76,65,65
66,55,55,65,65,67,67,77,77,66,66
67,56,56,66,66,78,78,67,67,67,67
68,57,57,69,69,79,79,68,68,68,68
69,58,58,68,68,70,70,80,80,69,69
70,59,59,69,69,71,71,81,81,70,70
71,60,60,70,70,72,72,82,82,71,71
72,61,61,71,71,73,73,83,83,72,72
73,62,62,72,72,74,74,84,84,73,73
74,63,63,73,73,75,75,85,85,74,74
75,64,64,74,74,76,76,86,86,75,75
76,65,65,75,75,77,77,87,87,76,76
77,66,66,76,76,78,78,88,88,77,77
78,67,67,77,77,89,89,78,78,78,78
79,68,68,80,80,90,90,79,79,79,79
80,69,69,79,79,81,81,91,91,80,80
81,70,70,80,80,82,82,92,92,81,81
82,71,71,81,81,83,83,93,93,82,82
83,72,72,82,82,84,84,94,94,83,83
84,73,73,83,83,85,85,95,95,84,84
85,74,74,84,84,86,86,96,96,85,85
86,75,75,85,85,87,87,97,97,86,86
87,76,76,86,86,88,88,98,98,87,87
88,77,77,87,87,89,89,99,99,88,88
89,78,78,88,88,100,100,89,89,89,89
90,79,79,91,91,101,101,90,90,90,90
91,80,80,90,90,92,92,102,102,91,91
92,81,81,91,91,93,93,103,103,92,92
93,82,82,92,92,94,94,104,104,93,93
94,83,83,93,93,95,95,105,105,94,94
95,84,84,94,94,96,96,106,106,95,95
96,85,85,95,95,97,97,107,107,96,96
97,86,86,96,96,98,98,108,108,97,97
98,87,87,97,97,99,99,109,109,98,98
99,88,88,98,98,100,100,110,110,99,99
100,89,89,99,99,111,111,100,100,100,100
101,90,90,102,102,112,112,101,101,101,101
102,91,91,101,101,103,103,113,113,102,102
103,92,92,102,102,104,104,114,114,103,103
104,93,93,103,103,105,105,115,115,104,104
105,94,94,104,104,106,106,116,116,105,105
106,95,95,105,105,107,107,117,117,106,106
107,96,96,106,106,108,108,118,118,107,107
108,97,97,107,107,109,109,119,119,108,108
109,98,98,108,108,110,110,120,120,109,109
110,99,99,109,109,111,111,121,121,110,110
111,100,100,110,110,122,122,111,111,111,111
112,101,101,113,113,12,12,112,112,112,112
113,102,102,112,112,114,114,113,113,113,113
114,103,103,113,113,115,115,114,114,114,114
115,104,104,114,114,116,116,115,115,115,115
116,105,105,115,115,117,117,116,116,116,116
117,106,106,116,116,118,118,117,117,117,117
118,107,107,117,117,119,119,118,118,118,118
119,108,108,118,118,120,120,119,119,119,119
120,109,109,119,119,121,121,120,120,120,120
121,110,110,120,120,122,122,121,121,121,121
122,123,111,111,121,121,2,2,122,122,122
123,122
