39,780
1,2
2,1,3,3,3,3,3,3,3,3,3
3,2,2,2,2,2,2,2,2,2,4
4,5,6,7,8,9,10,3,4,4,4
5,4,6,7,8,9,10,11,12,5,5
6,4,5,7,8,9,10,13,14,6,6
7,4,5,6,8,9,10,15,16,7,7
8,4,5,6,7,9,10,17,18,8,8
9,4,5,6,7,8,10,19,20,9,9
10,4,5,6,7,8,9,21,22,10,10
11,5,12,12,12,12,12,12,12,12,12
12,5,11,11,11,11,11,11,11,11,11
13,6,14,13,13,13,13,13,13,13,13
14,6,13,23,14,14,14,14,14,14,14
15,7,16,16,16,16,16,16,16,16,16
16,7,15,15,15,15,15,15,15,15,15
17,8,18,17,17,17,17,17,17,17,17
18,8,17,25,18,18,18,18,18,18,18
19,9,20,20,20,20,20,20,20,20,20
20,9,19,19,19,19,19,19,19,19,19
21,10,22,21,21,21,21,21,21,21,21
22,10,21,27,22,22,22,22,22,22,22
23,28,28,28,28,28,24,24,24,24,14
24,23,23,23,23,25,25,25,25,25,29
25,24,24,24,24,24,26,26,26,26,18
26,25,25,25,25,27,27,27,27,27,36
27,26,26,26,26,26,28,28,28,28,22
28,23,23,23,23,23,27,27,27,27,39
29,24,30,30,29,29,29,29,29,29,29
30,29,29,31,31,30,30,30,30,30,30
31,30,30,32,32,31,31,31,31,31,31
32,31,31,33,33,37,32,32,32,32,32
33,32,32,34,34,33,33,33,33,33,33
34,33,33,35,35,38,34,34,34,34,34
35,34,34,36,36,35,35,35,35,35,35
36,26,35,35,36,36,36,36,36,36,36
37,32,37,37,37,37,37,37,37,37,37
38,34,38,38,38,38,38,38,38,38,38
39,28
