58,1000
1,2
2,1,2,4,4,3,3,5,5,6,6
3,3,3,2,2,5,5,4,4,7,7
4,2,2,3,3,8,8,6,6,4,4
5,2,2,3,3,6,6,25,25,5,5
6,4,4,2,2,5,5,9,9,6,6
7,3,3,7,7,7,7,7,7,7,7
8,4,4,8,8,8,8,8,8,8,8
9,6,6,11,11,13,13,10,10,9,9
10,9,9,13,13,12,12,17,17,10,10
11,9,9,13,13,12,12,15,15,11,11
12,13,13,11,11,10,10,16,16,12,12
13,11,11,12,12,14,14,9,9,10,10
14,13,13,14,14,14,14,14,14,14,14
15,11,11,15,15,15,15,15,15,15,15
16,12,12,55,55,55,55,55,16,16,16
17,10,10,18,18,20,20,22,22,17,17
18,17,17,21,21,19,19,26,26,18,18
19,22,22,18,18,20,20,48,48,19,19
20,21,21,19,19,17,17,37,37,20,20
21,18,18,22,22,20,20,23,23,21,21
22,17,17,21,21,19,19,24,24,22,22
23,21,21,23,23,23,23,23,23,23,23
24,22,22,24,24,24,24,24,24,24,24
25,5,5,27,27,26,26,31,31,25,25
26,25,25,31,31,28,28,18,18,26,26
27,29,29,25,25,28,28,31,31,27,27
28,26,26,27,27,31,31,30,30,28,28
29,27,27,29,29,29,29,29,29,29,29
30,28,28,33,33,33,33,33,30,30,30
31,27,27,25,25,26,26,28,28,32,32
32,31,31,32,32,32,32,32,32,32,32
33,30,30,30,30,30,34,34,34,34,34
34,33,33,33,33,33,35,35,34,34,34
35,34,34,37,37,36,36,40,40,35,35
36,39,39,38,38,35,35,40,40,36,36
37,20,20,35,35,38,38,40,40,37,37
38,37,37,40,40,36,36,42,42,38,38
39,36,36,39,39,39,39,39,39,39,39
40,35,35,37,37,38,38,36,36,41,41
41,40,40,41,41,41,41,41,41,41,41
42,38,38,43,43,44,44,46,46,42,42
43,47,47,42,42,45,45,46,46,43,43
44,42,42,46,46,45,45,57,57,44,44
45,56,56,43,43,44,44,46,46,45,45
46,45,45,43,43,42,42,44,44,58,46
47,43,43,48,48,52,52,50,50,47,47
48,19,19,49,49,47,47,52,52,48,48
49,54,54,48,48,50,50,52,52,49,49
50,51,51,52,52,47,47,49,49,50,50
51,50,50,51,51,51,51,51,51,51,51
52,53,53,50,50,49,49,48,48,47,47
53,52,52,53,53,53,53,53,53,53,53
54,49,49,55,55,55,55,55,54,54,54
55,54,54,54,54,54,16,16,16,16,16
56,45,45,56,56,56,56,56,56,56,56
57,44,44,57,57,57,57,57,57,57,57
58,46
