28,840
1,2
2,1,3,4,9,10,15,16,21,22,27
3,2,3,5,8,11,14,17,20,23,26
4,2,4,6,7,12,13,18,19,24,25
5,3,5,6,7,12,13,18,19,24,25
6,4,5,6,8,11,14,17,20,23,26
7,4,5,7,9,10,15,16,21,22,27
8,3,6,8,9,10,15,16,21,22,27
9,2,7,8,9,11,14,17,20,23,26
10,2,7,8,10,12,13,18,19,24,25
11,3,6,9,11,12,13,18,19,24,25
12,4,5,10,11,12,14,17,20,23,26
13,4,5,10,11,13,15,16,21,22,27
14,3,6,9,12,14,15,16,21,22,27
15,2,7,8,13,14,15,17,20,23,26
16,2,7,8,13,14,16,18,19,24,25
17,3,6,9,12,15,17,18,19,24,25
18,4,5,10,11,16,17,18,20,23,26
19,4,5,10,11,16,17,19,21,22,27
20,3,6,9,12,15,18,20,21,22,27
21,2,7,8,13,14,19,20,21,23,26
22,2,7,8,13,14,19,20,22,24,25
23,3,6,9,12,15,18,21,23,24,25
24,4,5,10,11,16,17,22,23,24,26
25,4,5,10,11,16,17,22,23,25,27
26,3,6,9,12,15,18,21,24,26,27
27,2,7,8,13,14,19,20,25,26,28
28,27