12,32
1,2
2,1,2,2,2,2,2,3,3,4,4
3,3,4,5,6,7,8,9,10,2,2
4,3,4,5,6,7,8,9,10,2,2
5,3,4,5,6,7,8,9,10,5,5
6,3,4,5,6,7,8,9,10,6,6
7,3,4,5,6,7,8,9,10,7,7
8,3,4,5,6,7,8,9,10,8,8
9,3,4,5,6,7,8,9,10,11,11
10,3,4,5,6,7,8,9,10,11,11
11,9,9,10,10,11,11,11,11,11,12
12,11
