15,100
1,2
2,1,3,2,11,2,2,2,2,2,2
3,2,4,3,3,3,3,3,3,3,3
4,3,5,9,4,4,4,4,4,4,4
5,4,6,5,5,5,5,5,5,5,5
6,5,7,6,6,6,6,6,6,6,6
7,6,8,7,7,7,7,7,7,7,7
8,7,9,8,8,8,8,8,8,8,8
9,8,10,4,9,9,9,9,9,9,9
10,9,11,10,10,10,10,10,10,10,10
11,10,12,11,2,11,11,11,11,11,11
12,11,13,12,12,12,12,12,12,12,12
13,12,14,13,13,13,13,13,13,13,13
14,13,15,14,14,14,14,14,14,14,14
15,14