12,15
1,2
2,1,2,2,3,3,3,3,7,7,7
3,2,2,2,2,3,3,4,4,5,5
4,3,3,5,5,5,6,6,6,6,4
5,3,3,4,4,4,5,5,5,5,5
6,4,4,4,4,6,6,6,6,6,6
7,2,2,2,8,8,8,7,7,7,7
8,7,7,7,9,9,9,10,10,10,10
9,8,8,8,9,9,9,9,9,9,9
10,8,8,8,8,11,11,11,11,11,11
11,10,10,10,10,10,10,11,11,11,12
12,11