25,250
1,2
2,3,4,5,6,7,8,9,10,11,1
3,2,4,5,6,7,8,9,10,11,12
4,2,3,5,6,7,8,9,10,11,12
5,2,3,4,6,7,8,9,10,11,12
6,2,3,4,5,7,8,9,10,11,12
7,2,3,4,5,6,8,9,10,11,12
8,2,3,4,5,6,7,9,10,11,12
9,2,3,4,5,6,7,8,10,11,12
10,2,3,4,5,6,7,8,9,11,12
11,2,3,4,5,6,7,8,9,10,12
12,3,4,5,6,7,8,9,10,11,13
13,12,16,13,13,13,13,13,13,13,13
14,14,14,14,14,14,14,14,14,14,14
15,16,18,16,19,15,15,15,15,15,15
16,13,15,17,19,22,15,20,16,16,16
17,16,18,20,23,18,24,17,17,17,17
18,17,19,15,21,17,21,20,18,18,18
19,18,20,16,22,15,22,19,19,19,19
20,19,21,17,21,16,18,23,20,20,20
21,20,18,20,18,21,21,21,21,21,21
22,22,22,19,16,19,22,22,22,22,22
23,23,23,24,17,24,20,23,23,23,23
24,23,23,17,25,24,24,24,24,24,24
25,24
